***********************************
*******************        ********
**    *************         *******
**    *************   x     *******
**                    #  **********
**       x#           o  **********
******    ***********    **********
******    *************************
******    *************************
***********************************
***********************************
***********************************
