***********************************
*******************        ********
**    *************   #     *******
**   x# ***********   x     *******
**                       **********
**                       **********
******    ***********    **********
******   o*************************
******    *************************
***********************************
***********************************
***********************************
