1111111111
1200011111
1101111111
1100111111
1000011111
1050011111
1100111111
1100301111
1111111111
1111111111
