1111111111
1000011111
1111111111
1100111111
1020011111
1050011111
1100111111
1100301111
1111111111
1111111111
