8 8 8 8 8 8 8 8 8 8 8 8 8 8 8 8 8 8 8 8 
8 8 8 4 4 4 4 8 8 8 8 8 8 8 8 8 8 8 8 8 
8 8 8 4 3 4 3 8 8 8 8 8 8 8 8 8 8 8 8 8 
8 8 8 8 4 4 3 4 8 8 8 8 8 8 8 8 8 8 8 8 
8 8 8 8 4 4 4 4 8 8 8 8 8 8 8 8 8 8 8 8 
8 8 8 8 8 8 4 8 8 8 8 8 8 8 8 8 8 8 8 8 
8 8 8 8 8 8 4 8 8 8 8 8 8 8 8 8 8 8 8 8 
8 8 8 8 8 8 4 8 8 8 8 8 2 8 8 8 8 8 8 8 
8 8 8 8 8 8 1 8 8 8 8 8 2 8 8 8 8 8 8 8 
8 8 8 8 8 8 4 8 8 8 8 8 4 8 8 8 8 8 8 8 
8 8 8 8 8 8 4 8 8 8 8 8 4 8 8 8 8 8 8 8 
8 8 8 8 8 8 4 8 8 8 8 8 4 8 8 8 8 8 8 8 
8 8 4 4 8 8 4 4 8 8 8 8 4 4 4 2 4 8 8 8 
8 4 4 4 4 4 4 4 8 8 8 8 4 4 8 4 4 8 8 8 
8 8 4 8 8 8 8 8 8 8 8 8 8 8 8 4 8 8 8 8 
8 8 4 8 8 8 8 8 8 8 8 8 4 4 4 4 8 8 8 8 
8 4 4 8 8 8 8 8 8 8 8 8 4 4 4 4 8 8 8 8 
8 4 4 4 4 4 4 4 4 4 4 4 4 4 4 4 8 8 8 8 
8 8 8 8 8 8 8 8 8 8 8 8 8 8 4 4 8 8 8 8 
8 8 8 8 8 8 8 8 8 8 8 8 8 8 8 8 8 8 8 8 