0 0 0 0 0 0 0 0
0 0 0 3 0 0 0 0
0 0 0 1 0 0 0 0
0 0 0 4 1 4 3 0
0 3 1 4 2 0 0 0
0 0 0 0 4 0 0 0
0 0 0 0 3 0 0 0
0 0 0 0 0 0 0 0
0 0 0 0 0 0 0 0 
0 0 1 1 1 0 0 0
0 0 1 1 4 0 0 0
0 0 3 1 2 1 1 0
0 0 3 4 1 0 1 0
0 0 0 1 1 1 1 0
0 0 0 0 0 0 0 0 
0 0 0 0 0 0 0 0