1 1 1 1 1 1 1 1 1 1
1 1 1 1 0 0 0 0 1 1
1 1 4 0 3 1 1 0 1 1
1 4 4 3 0 3 0 0 2 1
1 4 4 0 3 0 3 0 1 1
1 1 1 1 1 1 0 0 1 1
1 1 1 1 1 1 1 1 1 1
1 1 1 1 1 1 1 1 1 1
1 1 1 1 1 1 1 1 1 1
1 1 1 1 1 1 1 1 1 1
3 8 5 2 2 3 1 3 2 4 1 4 2