7 11
***********
*T       T*
*        T*
*o  *******
*    o  o *
X         *
***********
7 10
**********
****    **
**T o * **
*TTo o  X*
*TT o o **
******  **
**********
10 11
***********
*****X*****
****   ****
*** o o ***
**  *T*  **
**  TTT  **
*   * *   *
* o     o *
****   ****
***********