7 11
***********
*T*      T*
*        T*
*o ********
*       o *
.     o   *
***********
7 10
**********
****    **
**T o** **
*TTo o  .*
*TT o o **
******  **
**********
10 11
***********
*****.*****
****   ****
*** o o ***
**  *T*  **
**  TTT  **
*   * *   *
* o     o *
****   ****
***********