7 11
***********
*T*      T*
*        T*
*o ********
*       o *
.     o   *
***********