7 10 6 4
1111111111
1110000111
1113112011
1103320011
1100120011
1100401111
1111111111