11 12
##*#########
#   ###  # #
# # # #  # #
#   ### ## #
# ####     #
#  # ### ###
##   ##  # #
### ##  ## #
##  ### #  #
##        ##
######### ##